26 26 26 26 26 26 26 26 26 26 26 26 26 26 26 26 26 26 26 26 26 26 26 26 26 
26 16 16 16 26 16 16 16 16 16 16 16 16 16 16 16 16 16 16 26 16 16 16 16 26 
26 16 16 16 16 16 16 26 16 16 16 16 16 26 26 26 26 26 16 26 16 16 16 16 26 
26 16 16 16 26 16 16 26 26 26 16 16 16 26 16 16 16 16 16 26 16 26 26 26 26
26 26 26 26 26 16 16 16 16 16 16 16 16 26 16 16 16 16 16 16 16 16 16 16 26 
26 16 16 16 16 16 16 16 16 16 16 26 16 16 16 16 26 16 16 16 26 16 16 16 26 
26 16 16 16 16 16 26 16 16 16 16 26 26 26 26 26 26 16 16 16 16 16 16 16 26 
26 16 26 26 26 16 16 16 16 16 16 16 16 16 16 16 26 26 26 26 26 16 16 16 26 
26 16 16 16 26 16 16 26 26 26 26 26 16 16 16 16 16 16 16 16 26 16 16 16 26 
26 16 16 16 26 16 16 26 16 16 16 16 16 16 16 16 16 16 16 16 26 26 26 26 26 
26 16 26 16 16 16 16 26 16 16 16 16 16 16 16 16 16 26 16 16 26 16 31 16 26
26 16 26 16 16 16 16 16 16 26 16 26 26 26 16 16 26 26 26 16 26 16 16 16 26 
26 16 26 26 26 26 16 16 16 26 16 16 16 26 16 16 16 26 16 16 16 16 16 16 26 
26 16 16 16 16 16 16 16 16 26 16 16 16 26 16 16 16 16 16 16 26 16 16 16 26 
26 26 26 26 26 26 26 26 26 26 26 26 26 26 26 26 26 26 26 26 26 26 26 26 26 
