27 27 27 27 27 27 27 27 27 27 27 27 27 27 27 27 27 27 27 27 27 27 27 27 27 
27 15 15 15 15 15 15 15 27 15 15 15 15 15 15 15 15 15 27 15 15 15 15 15 27 
27 15 15 15 27 15 15 15 27 27 27 27 15 27 15 15 15 15 27 15 15 15 15 15 27 
27 15 15 15 27 15 15 15 15 15 15 27 15 27 27 27 15 15 27 27 27 27 15 15 27 
27 27 27 27 27 15 15 15 27 15 15 27 15 15 32 27 15 15 15 15 15 27 15 15 27
27 15 15 15 15 15 27 15 27 15 15 27 27 27 27 27 15 15 15 15 15 27 15 15 27 
27 15 15 27 27 27 27 15 27 15 15 15 15 15 15 27 15 15 15 15 15 27 15 27 27 
27 15 15 27 15 15 15 15 15 15 15 15 15 15 15 27 27 27 27 27 15 27 15 15 27 
27 15 15 27 15 15 27 27 27 27 27 15 27 15 15 15 15 15 15 15 15 15 15 15 27 
27 15 15 15 15 15 27 15 15 15 27 15 15 27 15 15 15 15 15 15 15 15 15 15 27 
27 15 27 27 15 15 27 15 15 15 27 15 15 15 15 15 15 15 15 15 15 15 15 15 27 
27 15 15 27 15 15 27 15 15 15 27 27 27 15 27 15 15 15 15 15 27 15 27 27 27 
27 15 15 27 15 15 27 15 27 27 27 15 15 15 27 15 15 15 15 15 27 15 15 15 27 
27 15 15 15 15 15 15 15 15 15 27 15 15 15 27 15 15 15 15 15 27 15 15 15 27
27 27 27 27 27 27 27 27 27 27 27 27 27 27 27 27 27 27 27 27 27 27 27 27 27 