17 17 17 17 17 17 17 17 17 17 17 17 17 17 17 17 17 17 17 17 17 17 17 17 17
17 13 13 13 13 13 13 13 13 13 13 13 13 13 13 13 13 17 13 13 13 17 13 13 17
17 13 13 13 17 13 13 13 13 13 13 13 13 13 13 13 13 17 24 13 13 13 13 13 17
17 13 13 13 17 13 17 17 17 17 17 17 17 13 13 13 13 17 13 13 13 17 13 13 17
17 17 17 17 17 13 17 13 13 13 13 13 13 13 13 13 13 17 17 17 17 17 17 13 17
17 13 13 13 13 13 17 13 13 13 13 13 13 13 13 13 13 13 13 13 13 13 13 13 17
17 13 13 13 13 13 17 17 17 17 17 17 17 13 13 13 13 13 13 17 17 17 13 13 17
17 13 13 13 13 13 13 13 13 13 13 13 17 13 13 13 13 13 13 13 13 17 13 13 17
17 13 13 13 13 13 13 13 13 13 13 13 17 13 17 17 13 13 17 17 17 17 13 13 17
17 13 13 17 17 17 17 17 17 13 17 17 17 13 13 17 13 13 17 13 13 13 13 13 17
17 13 13 13 13 13 13 17 13 13 13 13 17 13 13 17 13 13 17 13 13 13 13 13 17
17 17 13 13 17 13 13 17 13 13 13 13 17 13 13 17 17 13 13 13 13 17 17 17 17
17 13 13 13 17 13 13 17 17 17 17 17 17 13 13 13 13 13 13 13 13 17 13 13 17
17 13 13 13 17 13 13 13 13 13 13 13 13 13 13 13 13 13 13 13 13 13 13 13 17
17 17 17 17 17 17 17 17 17 17 17 17 17 17 17 17 17 17 17 17 17 17 17 17 17
