29 29 29 29 29 29 29 29 29 29 29 29 29 29 29 29 29 29 29 29 29 29 29 29 29 
29 11 29 11 11 11 11 29 11 11 11 11 11 11 11 11 11 11 11 11 11 11 29 11 29 
29 11 11 11 29 29 29 29 11 29 29 11 29 11 11 11 29 29 29 29 29 11 29 11 29 
29 29 29 11 11 11 11 11 11 29 11 11 29 11 11 11 11 11 11 11 29 11 29 11 29 
29 11 11 11 11 11 11 29 11 11 11 11 29 29 29 29 29 29 29 11 29 11 11 11 29
29 11 29 29 29 29 11 29 29 29 29 29 29 11 11 11 29 11 11 11 29 11 29 11 29
29 11 11 29 11 11 11 29 11 11 11 11 29 11 11 11 29 11 11 11 29 11 29 11 29 
29 11 29 29 11 11 11 29 11 29 11 11 29 11 11 11 29 11 11 11 11 11 29 11 29 
29 11 11 11 11 11 11 29 11 11 29 11 29 11 29 29 29 29 29 29 29 29 29 11 29 
29 11 11 29 29 29 29 29 11 11 11 11 11 11 11 11 11 11 11 11 11 11 29 11 29 
29 11 11 29 11 11 11 11 11 11 29 29 29 29 29 11 11 11 11 11 29 11 29 11 29 
29 29 29 29 11 11 11 11 11 11 11 29 11 11 29 11 29 29 29 11 29 11 11 11 29 
29 11 11 29 11 29 29 29 11 29 29 29 11 11 29 11 29 11 11 11 29 11 29 11 29 
29 11 11 11 11 11 11 29 11 11 11 11 11 11 11 11 29 11 11 11 29 11 11 11 29
29 29 29 29 29 29 29 29 29 29 29 29 29 29 29 29 29 29 29 29 29 29 29 29 29 