20 20 20 20 20 20 20 20 20 20 20 20 20 20 20 20 20 20 20 20 20 20 20 20 20 20                         
20 14 14 14 14 17 14 14 14 14 14 14 14 14 14 17 14 14 14 14 14 14 14 14 20 20                         
20 14 14 14 14 17 14 14 14 14 14 14 14 14 14 14 14 14 14 17 14 14 14 14 20 20                         
20 14 14 14 14 14 14 14 14 17 14 14 14 14 14 14 14 14 14 17 14 14 17 14 20 20                         
20 17 17 17 17 17 14 14 14 14 14 14 14 14 14 17 14 14 14 17 14 14 14 14 20 20                         
20 14 14 14 14 14 14 14 14 14 14 14 14 14 14 17 14 14 14 17 17 14 14 17 20 20                         
20 14 14 14 14 17 17 17 14 14 14 17 17 17 17 17 14 14 14 14 14 14 14 14 20 20                         
20 14 14 14 14 14 14 17 14 14 14 14 14 14 14 14 14 14 14 14 14 14 14 14 20 20                         
20 14 14 14 14 14 14 17 14 14 14 14 14 14 14 14 14 17 14 14 17 17 17 17 20 20
20 14 17 17 17 17 17 17 14 14 14 14 14 14 14 14 14 14 14 14 17 14 14 14 20 20
20 14 17 14 14 14 14 14 14 14 14 14 14 14 14 14 14 14 14 14 14 14 14 14 20 20                         
20 14 17 14 14 14 17 14 14 14 14 17 17 17 14 14 17 14 14 14 17 17 14 17 20 20                         
20 14 17 17 17 14 14 14 14 14 14 17 14 14 14 14 17 17 17 14 17 14 14 14 20 20                         
20 14 14 14 14 14 14 14 14 14 14 17 14 14 14 14 14 14 14 14 17 14 14 21 20 20
20 20 20 20 20 20 20 20 20 20 20 20 20 20 20 20 20 20 20 20 20 20 20 20 20 20                         

